00000000000000000000000000000000000000000000000000000000000000000000000000000000000000000000000000000000000000000000000000000000000000000000000000000000000000000000000000000000000000000000000000000000000000000000000000000000000000000000000000000000404036dd
ffffffff400088000000000000006420ffffffff8000c8000000000000006420ffffffff308080000000000000000000ffffffff3040c0000000000000000000ffffffff140342000000000000003210ffffffff1801c2000000000000003210ffffffff310242000000000076543210ffffffff320042000000000076543210
00000000000000000000000000ff05ff00000000000000000000000000ff05ff0000000000000000000000001cff01ff0000000000000000000000001cff05ff000000000000000000000000000005ff000000000000000000000000000005ff000000000000000000000000000001ff000000000000000000000000000001ff
000000000000000000000000000030000000000000000000000000000000300000000ffbc10a0950000000000002002100044ff4000a708400000000000080210000000000000000000000000018cc80000000000000000000000000801ccc80000000000000000000000000000003c0000000000000000000000000000003f0
0000000000000000000000000000019a0000000000000000000000000000099a000000000000003f000000000000003f00064ffc00107084000000000000f821000800210010002b00001c26000010217ffffc0d00002c2620210411000010211c0040391c01001900020021080000a60000003f8000401900080021080000a6
0000000000000000000000000800000000000000000000000000000010000000ffffffff000000000000000000000000000000000000003f0000cffbc10a0c10000010213fe0004c0008002ba00200190000003f0000003f0000003fe6c404081c0048391c0008391c00c0391c008039ffffffff000000000000000000000000
0000000000000000000000000000000000000000000000000000000000000000ffffffff000000000000000000000000ffffffff00000000000000000000000020040079200200792020005900002021ffffffff2800820000000000000032101c0050391c0010391c00c8391c008839ffffffff000000000000000000000000
8000002b000080300000800800001030000008300000004000028c0c00001030ffffffff000000000000000000000000ffffffff000000000000000000000000d26404087ffffc0dff080048a0060079000000000000000000000000000005ff1c0058391c0018391c00d0391c009039ffffffff000000000000000000000000
0000003700000037802cd00200014c0c0007c005040000a30000009100000490ffffffff000000000000000000000000ffffffff0000000000000000000000000000003f0000003f0000003f0000003f000000000000000000000000801cd4801c0060391c0020391c00d8391c009839ffffffff000000000000000000000000
ffffffff0000000000000000000000000000003700000037804d500280004041ffffffff000000000000000000000000ffffffff000000000000000000000000ffffffff2401420000000000000032107ffffc0d00002c2620210411000010211c0068391c0028391c00e0391c00a039ffffffff000000000000000000000000
ffffffff000000000000000000000000ffffffff000000000000000000000000ffffffff000000000000000000000000ffffffff000000000000000000000000000000000000000000000000000005ff0000003f0000003f0000003fe70404081c0070391c0030391c00e8391c00a839ffffffff000000000000000000000000
ffffffff000000000000000000000000ffffffff000000000000000000000000ffffffff000000000000000000000000ffffffff0000000000000000000000000000000000000000000000000019cc80ffffffff0000000000000000000000001c0078391c0038391c00f0391c00b039ffffffff000000000000000000000000
ffffffff000000000000000000000000ffffffff000000000000000000000000ffffffff000000000000000000000000ffffffff000000000000000000000000000800210010002b00001c2600001021ffffffff0000000000000000000000000000003f0000003f9c00f8391c00b839ffffffff000000000000000000000000
ffffffff000000000000000000000000ffffffff000000000000000000000000ffffffff000000000000000000000000ffffffff000000000000000000000000000010213fe0004c0008002ba0020019ffffffff000000000000000000000000ffffffff000000000000000000000000ffffffff000000000000000000000000
ffffffff000000000000000000000000ffffffff000000000000000000000000ffffffff000000000000000000000000ffffffff00000000000000000000000020040079200200792020005900002021ffffffff000000000000000000000000ffffffff000000000000000000000000ffffffff000000000000000000000000
ffffffff000000000000000000000000ffffffff000000000000000000000000ffffffff000000000000000000000000ffffffff000000000000000000000000da6404087ffffc0dff080048a0060079ffffffff000000000000000000000000ffffffff000000000000000000000000ffffffff000000000000000000000000
ffffffff000000000000000000000000ffffffff000000000000000000000000ffffffff000000000000000000000000ffffffff0000000000000000000000000000003f0000003f0000003f0000003fffffffff000000000000000000000000ffffffff000000000000000000000000ffffffff000000000000000000000000
ffffffff302100000000000000000000ffffffff302100000000000000000000ffffffff302100000000000000000000ffffffff302100000000000000000000ffffffff302100000000000000000000ffffffff302100000000000000000000ffffffff302100000000000000000000ffffffff302100000000000000000000
00000000000000000000000000ff05ff00000000000000000000000000ff05ff00000000000000000000000000ff05ff00000000000000000000000000ff05ff00000000000000000000000000ff05ff00000000000000000000000000ff05ff00000000000000000000000000ff05ff00000000000000000000000000ff05ff
0000102100000121000010280010002800000221000001210000102800100028000002210000012100001028001000280000022100000121000010280010002800000221000001210000102800100028000002210000012100001028001000280000022100000121000010280010002800000221000001210000102800100028
80000020000000200000002000e0f7c3000001210010002898fcf7c318e0f7c30010002898fcf7c318fcf7c318e0f7c398fcf7c318fcf7c318fcf7c318e0f7c38000002098fcf7c30000012118e0f7c38000002098fcf7c30000016118e0f7c38000002098fcf7c3000001a118e0f7c38000002098fcf7c3000001e118e0f7c3
1402b7830000082100000121001000288000102892fe83831402b7830000082192fe83831402b78300000821000001211402b7830000082100000121001000281402b7830000082100000121001000281402b7830000082100000121001000281402b7830000082100000121001000281402bf83000008210000012100100028
0000003f800000208000102892fe83830000003f0000003f0000003f800000200000003f0000003f80000020800010280000003f800000208000102892fe83830000003f800000208000102892fe83830000003f800000208000102892fe83830000003f800000208000102892fe83830000003f800000208000102892fe8383
00000000000000000000000000000000000000000000000000000000000000000000000000000000000000000000000000000000000000000000000000000000ffffffff140142000000000000003210ffffffff18008200000000000000321000000000000000000000000000000000ffffffff000000190000000000003f00
0000000000000000000000000000000000000000000000000000000010000010000000000000000000000000000000000000000000000000000000000000000000000000000000000000000000000000000000000000000000000000000000000000000000000000000000000000000000000002000000810000000000003f04
0000000000000000000000000000000000000000000000000000000010000020000000000000000000000000000000000000000000000000000000000000000000000000000000000000000000000000000000000000000000000000000000000000000000000000000000000000000000000004000000810000000000003f04
0000000000000000000000000000000000000000000000000000000010000030000000000000000000000000000000000000000000000000000000000000000000000000000000000000000000000000000000000000000000000000000000000000000000000000000000000000000000000008000000810000000000003f04
0000000000000000000000000000000000000000000000000000000010000040000000000000000000000000000000000000000000000000000000000000000000000000000000000000000000000000000000000000000000000000000000000000000000000000000000000000000000000010000000810000000000003f04
0000000000000000000000000000000000000000000000000000000010000050000000000000000000000000000000000000000000000000000000000000000000000000000000000000000000000000000000000000000000000000000000000000000000000000000000000000000000000020000000810000000000003f04
0000000000000000000000000000000000000000000000000000000010000060000000000000000000000000000000000000000000000000000000000000000000000000000000000000000000000000000000000000000000000000000000000000000000000000000000000000000000000040000000810000000000003f04
0000000000000000000000000000000000000000000000000000000010000070000000000000000000000000000000000000000000000000000000000000000000000000000000000000000000000000000000000000000000000000000000000000000000000000000000000000000000000080000000810000000000003f04
0000000000000000000000000000000000000000000000000000000010000080000000000000000000000000000000000000000000000000000000000000000000000000000000000000000000000000000000000000000000000000000000000000000000000000000000000000000000000100000000810000000000003f04
0000000000000000000000000000000000000000000000000000000010000090000000000000000000000000000000000000000000000000000000000000000000000000000000000000000000000000000000000000000000000000000000000000000000000000000000000000000000000200000000810000000000003f04
00000000000000000000000000000000000000000000000000000000100000a0000000000000000000000000000000000000000000000000000000000000000000000000000000000000000000000000000000000000000000000000000000000000000000000000000000000000000000000400000000810000000000003f04
00000000000000000000000000000000000000000000000000000000100000b0000000000000000000000000000000000000000000000000000000000000000000000000000000000000000000000000000000000000000000000000000000000000000000000000000000000000000000000800000000810000000000003f04
00000000000000000000000000000000000000000000000000000000100000c0000000000000000000000000000000000000000000000000000000000000000000000000000000000000000000000000000000000000000000000000000000000000000000000000000000000000000000001000000000810000000000003f04
00000000000000000000000000000000000000000000000000000000100000d0000000000000000000000000000000000000000000000000000000000000000000000000000000000000000000000000000000000000000000000000000000000000000000000000000000000000000000002000000000810000000000003f04
00000000000000000000000000000000000000000000000000000000100000e0000000000000000000000000000000000000000000000000000000000000000000000000000000000000000000000000000000000000000000000000000000000000000000000000000000000000000000004000000000810000000000003f04
00000000000000000000000000000000000000000000000000000000100000f0000000000000000000000000000000000000000000000000000000000000000000000000000000000000000000000000000000000000000000000000000000000000000000000000000000000000000000008000000000810000000000003f04
0000000000000000000000000000000000000000000000000000000010000100000000000000000000000000000000000000000000000000000000000000000000000000000000000000000000000000000000000000000000000000000000000000000000000000000000000000000000010000000000810000000000003f04
0000000000000000000000000000000000000000000000000000000010000110000000000000000000000000000000000000000000000000000000000000000000000000000000000000000000000000000000000000000000000000000000000000000000000000000000000000000000020000000000810000000000003f04
0000000000000000000000000000000000000000000000000000000010000120000000000000000000000000000000000000000000000000000000000000000000000000000000000000000000000000000000000000000000000000000000000000000000000000000000000000000000040000000000810000000000003f04
0000000000000000000000000000000000000000000000000000000010000130000000000000000000000000000000000000000000000000000000000000000000000000000000000000000000000000000000000000000000000000000000000000000000000000000000000000000000080000000000810000000000003f04
0000000000000000000000000000000000000000000000000000000010000140000000000000000000000000000000000000000000000000000000000000000000000000000000000000000000000000000000000000000000000000000000000000000000000000000000000000000000100000000000810000000000003f04
0000000000000000000000000000000000000000000000000000000010000150000000000000000000000000000000000000000000000000000000000000000000000000000000000000000000000000000000000000000000000000000000000000000000000000000000000000000000200000000000810000000000003f04
0000000000000000000000000000000000000000000000000000000010000160000000000000000000000000000000000000000000000000000000000000000000000000000000000000000000000000000000000000000000000000000000000000000000000000000000000000000000400000000000810000000000003f04
0000000000000000000000000000000000000000000000000000000010000170000000000000000000000000000000000000000000000000000000000000000000000000000000000000000000000000000000000000000000000000000000000000000000000000000000000000000000800000000000810000000000003f04
0000000000000000000000000000000000000000000000000000000010000180000000000000000000000000000000000000000000000000000000000000000000000000000000000000000000000000000000000000000000000000000000000000000000000000000000000000000001000000000000810000000000003f04
0000000000000000000000000000000000000000000000000000000010000190000000000000000000000000000000000000000000000000000000000000000000000000000000000000000000000000000000000000000000000000000000000000000000000000000000000000000002000000000000810000000000003f04
00000000000000000000000000000000000000000000000000000000100001a0000000000000000000000000000000000000000000000000000000000000000000000000000000000000000000000000000000000000000000000000000000000000000000000000000000000000000004000000000000810000000000003f04
00000000000000000000000000000000000000000000000000000000100001b0000000000000000000000000000000000000000000000000000000000000000000000000000000000000000000000000000000000000000000000000000000000000000000000000000000000000000008000000000000810000000000003f04
00000000000000000000000000000000000000000000000000000000100001c0000000000000000000000000000000000000000000000000000000000000000000000000000000000000000000000000000000000000000000000000000000000000000000000000000000000000000010000000000000810000000000003f04
00000000000000000000000000000000000000000000000000000000100001d0000000000000000000000000000000000000000000000000000000000000000000000000000000000000000000000000000000000000000000000000000000000000000000000000000000000000000020000000000000810000000000003f04
00000000000000000000000000000000000000000000000000000000100001e0000000000000000000000000000000000000000000000000000000000000000000000000000000000000000000000000000000000000000000000000000000000000000000000000000000000000000040000000000000810000000000003f04
00000000000000000000000000000000000000000000000000000000100001f0000000000000000000000000000000000000000000000000000000000000000000000000000000000000000000000000000000000000000000000000000000000000000000000000000000000000000080000000000000810000000000003f04
